S . . . # . . . . .
. # # . # . # # # .
. . . . . . . . # .
# # # # . # # . # .
. . . . . . . . . .
. # # # # # # # . .
. . . . . . . # . .
. # . # # # . # . .
. # . . . . . . . .
. . . # # # # # # G
